AGA|AGA|
ALLIBE|ALLIBERT|
AIRCO|AIRCO|
ACESA|ACESA|
AMETEX|AMETEX|
AGUILA|AGUILA|
ALPHAC|ALPHA COLOMBIA|
ARISTO|ARISTON|
AJOVER|AJOVER|
ARKOS|ARKOS|
ARMET|ARMET|
ALEMAN|ALEMANA|
APOLO|APOLO|
ALPHAJ|ALPHA JAPON|
ARO|ARO|
AISMIR|AISMIR|
ANZOLA|ANZOLA|
AGUT|AGUT|
ABB|ABB|
ACEROP|ACEROPAXI|
BRADY|BRADY|
BRAUKM|BRAUKMANN|
BDE|BDE|
BELLOT|BELLOT|
BRIGGS|BRIGGS|
BECKET|BECKETT|
BLISTE|BLISTER|
BMI|BMI|
BARNES|BARNES|
BRONWA|BRONWADE|
BARRLX|BARSON ROLLOX|
BARROT|BARSON ROTOR|
BURKS|BURKS|
BOLER|BOLER|
CASHAC|CASH ACME|
CORBIN|CORBIN|
CABLEC|CABLEC|
CASTEL|CASTELLON|
CREIN|CREIN|
CIFUNS|CIFUNSA|
CRANE|CRANE|
CHEMET|CHEMETRON|
CIALCO|CIALCO|
CALCO|CALCO|
CROMON|CROMO NIQUEL|
CONACA|CONACAL|
CORONA|CORONA|
CARRIE|CARRIER|
CIRCLE|CIRCLE SEAL|
CRESCE|CRESCENT BRAND-TAIWAN|
CASHCO|CASHCO|
CHOVA|CHOVA|
CKWORL|CK WORLDWIDE|
CORNET|CORNETO|
CONBRA|CONBRACO|
DORCHO|DORCHOA|
SIDERU|SIDERURGICA|
DEMING|DEMING  (CRANE DEMING)|
DUREX|DUREX|
EVANS|EVANS|
ECERAM|ECUACERAMICA|
EDESA|EDESA|
EMANGE|ECUAMANGUERAS|
EREJIL|ECUAREJILLAS|
ELKHAR|ELKHART|
EMPEO|EMPEO|
ENERPA|ENERPAC|
ECOLNI|ECOLNIT|
CERREC|CERRADURAS ECUATORIANAS|
EMSCO|EMSCO|
ETERNI|ETERNIT|
EPLAST|ECUAPLAST|
FRANKL|FRANKLIN|
FIBROP|FIBROPLAST|
FECSA|FECSA|
FECON|FECON|
FORJAN|FORJAN|
FIBRAS|FIBRASA|
FUJI|FUJI|
FAMAGR|FAMAGRO|
FROST|FROST|
FIBRAP|FIBRAPOLI|
FORMAC|FORMACRIL|
FASCOR|FASCOR|
FESTO|FESTO|
FVSANI|FV SANITARIOS|
FVGRIF|FV GRIFERIA|
FILMTE|FILMTEXSA|
FLEXIL|FLEXILUZ|
GRIVAL|GRIVAL|
GUILLE|GUILLETT|
GENERA|GENERAL ELECTRIC|
GEO|GEO|
GORMAN|GORMAN RUPP|
GRINNE|GRINNELL|
GESTRA|GESTRA|
GOULD|GOULD|
HANNA|HANNA|
HIDROS|HIDROSTAL|
HANCOC|HANCOCK GROSS|
HILTI|HILTI|
HELBER|HELBERT|
HARLOC|HARLOC|
HERCUL|HERCULES|
HANSA|HANSA|
HUMDIN|HUMDINGER|
HAWS|HAWS|
INCAME|INCAMEP|
INMESA|INMESA|
INCOTR|INCOTRADE|
INGLES|INGLESA|
ITALIA|ITALIANA|
ISKRA|ISKRA PERLES|
RIALTO|RIALTO|
IMPORT|IMPORTADO|
INTRAC|INTRACO|
INDUST|INDUSTRIAL|
INSINK|IN SINK ERATOR|
ITT|ITT|
IWKA|IWKA|
JHALAN|JHALANI|
JUMO|JUMO|
JENSEN|JENSEN|
JAPONE|JAPONES|
JET|JET|
KASUGA|KASUGA|
KECLEY|KECLEY|
KATADY|KATADYN|
KOHSAN|KOHLER SANITARIOS|
KOHGRI|KOHLER GRIFERIA|
KOHMOT|KOHLER MOTORES|
KWIKSE|KWIKSET|
KUKA|KUKA|
KLINGE|KLINGER|
KENACI|KENACI|
KONTAK|KONTAK|
KERAMI|KERAMIKOS|
KITO|KITO|
KUNKLE|KUNKLE|
KITZ|KITZ|
LICAUC|LICAUCHO|
LEISTE|LEISTER|
LUNKEN|LUNKENHEIMER|
LOMBAR|LOMBARDINI|
LUMESA|LUMESA|
LINZ|LINZ|
MIAMIC|MIAMI CAREY|
MADEPL|MADEPLAST|
MYERS|MYERS|
MIDGET|MIDGET|
MARATH|MARATHON ELECTRIC|
METISA|METISA|
MILLER|MILLER|
MANCES|MANCESA|
MICHEL|MICHELANGELO|
MIPEL|MIPEL|
MARKPE|MARK PEERLESS|
MOSA|MOSA|
MUELLE|MUELLER|
NIBCO|NIBCO|
NACION|NACIONAL|
NEWMAN|NEWMAN HENNDER|
NUTONE|NUTONE|
COCACO|COCACO|
ONAN|ONAN|
OVALIN|OVAL INMEDEC|
PIAZZA|PIAZZA|
PEDDIN|PEDDINGHAUS|
PFERD|PFERD|
PROIND|PROINDUSQUIN|
PILOT|PILOT|
PERMAC|PERMACALOR|
POLAR|POLAR|
POP|POP|
PERMAT|PERMATEX|
PISOPA|PISOPAK|
PLAGAM|PLASTIGAMA|
PERUAN|PERUANO|
PAVCO|PAVCO|
PLYCEM|PLYCEM|
RUSIA|RUSIA|
ROBROY|ROB ROY|
RITCO|RITCO|
RELIAN|RELIANCE|
ROOFTE|ROOFTEC|
RIDGID|RIDGID|
ROE|ROE|
REXPLA|REX PLASTICS|
RUSSWI|RUSSWING|
REDWHI|RED WHITE|
STARME|STARMENT|
SCOT|SCOT|
SIDEC|SIDEC|
STAHL|STAHL|
SUEHIR|SUEHIRO|
SIKA|SIKA|
SILLA|SILLA|
SUMITO|SUMITOMO|
SLOAN|SLOAN VALVE|
STRONG|STRONG|
SUSTRA|SUSTRAN|
STERLI|STERLING|
SAKUME|SAKUMETAL|
SANDVI|SANDVIK|
TUBELA|TUBELA|
STOCKA|STOCKAN|
THERMO|THERMOMATIC|
TECUMS|TECUMSEH|
T.L.V.|T.L.V.|
TEKA|TEKA|
BARTEL|BARTEL|
TAIMAN|TAIMAN|
TOMBO|TOMBO|
TURI|TURI|
TTB|TTB|
TRUSH|TRUSH|
TECVAL|TECVAL|
TOYA|TOYA|
UCEM|UCEM|
ULTRA|ULTRA FLEX|
UNIWEL|UNIWELD|
USMOTO|U.S.MOTORS|
WASINO|WASINO|
CIVA|CIVA|
VENCER|VENCERAMICA EDESA|
VOGUE|VOGUE|
VISEGR|VISE GRIP|
VERSAC|VERSACHEN|
WESARC|WES ARCO|
WELCO|WELCO|
WELLS|WELLS|
WEG|WEG|
WILSON|WILSON|
WELLMA|WELL MATE|
WOODS|WOODS|
WARRIC|WARRICK|
WESCO|WESCO|
WALWOR|WALWORT|
SHERWI|SHERWIN WILLIAMS|
ZAMORA|ZAMORANO|
LG|LG IND.|
C2|CALOREX.|
SCHUTZ|SCHUTZ|
MANNES|MANNESMANN BRASIL|
TEKVEN|TEKVEN|
IMSA|IMSA|
CUCASA|CUCASA|
IMPAG|IMPAG|
MC|MC|
IMBAGR|IMBAGRES|
CSM|CSM|
IMESCO|IMESCO|
COMBO|COMBO|
1AI|ACERO INOXIDABLE|
1AL|ALUMINIO|
1BC|BRONCE|
1BR|BROCAS|
1CU|COBRE|
1GA|GARRUCHAS|
1DS|DISCOS|
1SK|STOCKAN|
1SO|SOLDAR|
1TO|TOL|
1TC|TUBO COBRE|
1VG|VIGAS|
1SS|SANWA-SOLDAR|
1SJ|SANWA JAPONES|
SAYCO|SAYCO|
1HAG|HITACHI ACCESORIOS GALVANIZADO|
1HAN|HITACHI ACCESORIOS NEGRO|
1MAD|MADECO|
1LAG|LAG|
CAMPBE|CAMPBELL|
HITACH|HITACHI|
COPRAX|COPRAX|
APOLLO|APOLLO|
HIDNOX|HIDRINOX|
IDEAL|IDEAL|
ALLEN|ALLEN|
ARMSTR|ARMSTRONG|
GRUNDF|GRUNDFOS|
ACERO|ACERO COMERCIAL ECUATORIANO|
MATEX|MATEX SPAIN|
CATA|CATA|
JOHNVA|JOHN VALVE|
WEISS|WEISS|
